Map 2
win 4
####################
#...............E..#
#...G..............#
#.........G........#
#....#.............#
#...G..............#
#.............G....#
#...G..............#
####################