Map 3
win 5
####################
#...............E..#
#...G..............#
#.........G........#
#...G..............#
#.............G....#
#...G..............#
#..#...........G...#
####################