Map 4
win 2
####################
#...............E..#
#...G..............#
#.........G........#
#..................#
#...G..............#
#.............G....#
#..#...............#
####################